verki	to write (a poem) / to compose	
tramo	tram	
strato	street	
letero	letter	
poŝto	mail	
pomo	an apple	
matenmanĝo	breakfast	
vespermanĝo	dinner	
sono	sound	
multekosta	expensive	
flanko	side	
lumo	light	
facila	easy	
seka	dry	
fali	to fall	
kuŝi	to lie	
daŭri	to go on	
veni	to come	
miri	to be amazed	
konstrui	to build	
desegni	to draw	
trompi	to deceive	
ruĝa	red	
blua	blue	
verda	green	
flava	yellow	
blanka	white	
nigra	black	
griza	gray	
bruna	brown	
danĝera	danger	
naturo	nature	
feliĉa	happy	
signifi	to mean	
dekstra	right	
maldekstra	left	
Good evening!	Bonan vesperon!	
Good day!	Bonan tagon	
trovi	to find	
telero	a plate	
se	if	
laca	tired	
tro	too, too much	